        "PPPPPPPPPPPPPPPPPPPPPPPPPPPPPPPPPPPPPPPPPPPPPPPPPPPPPPPPPPPPPPPPPPPP",
        "P                 LP     LP                                        P",
        "P                  N     LP                                        P",
        "P                        LP                                        P",
        "P                        LP                                        P",
        "PPPPPPPP                 LP                                        P",
        "P               P  P     LP                                        P",
        "P                        LP                                        P",
        "P                        LP             M    LPPPP                 P",
        "P                        LP                    NNN                 P",
        "P                         P                                        P",
        "P                         P                                        P",
        "P                                                                  P",
        "P                                  P      P     P                  P",
        "P                            P                                     P",
        "P                         P                               PPP      P",
        "P                                                           P      P",
        "PS                                                          P      P",
        "P                                                           P      P",
        "P                                                           PGGGG  P",
        "P                                                           P      P",
        "P                                                           P      P",
        "P                                                           P      P",
        "P                                                           P      P",
        "P                                                           P      P",
        "P                                                           P      P",
        "P                                                           P      P",
        "P                                                           P      P",
        "PGGGGGGGGGGGGGGGGGGGGGGGGGGGGGGGGGGGGGGGGGGGGGGGGGGGGGGGGGGGP      P",
        "PPPPPPPPPPPPPPPPPPPPPPPPPPPPPPPPPPPPPPPPPPPPPPPPPPPPPPPPPPPPP   GGGP",
        "                                                            P      P",
        "                                                            P      P",
        "                                                            PEEEEEEP",
        "                                                            PPPPPPPP",]